||||||||||
|.....E..|
|......|.|
|......|.|
|......|.|
|......|.|
|E.....|.|
|..|||||.|
|V......P|
||||||||||