||||||||||
|........|
|.EEEEEE.|
|.EEEEEE.|
|.EEEEEE.|
|DEEEEEE.|
|........|
|.|.||.|.|
|...P....|
||||||||||