||||||||||
|P.......|
|......E.|
|.....EEE|
|........|
|..||....|
|...||...|
||....||.|
||||..||D|
||||||||||