||||||||||
||E....P||
|.|E.EE|.|
|..|EE|..|
|........|
|........|
|..|..|..|
|.|....|.|
||D.....||
||||||||||