||||||||||
||......D|
|........|
|.......||
|EEEEEEE.|
|.......||
|........|
|........|
||......P|
||||||||||