||||||||||
|P.......|
||||||||.|
||.......|
||..|||.||
||..|D|v||
||..|E..||
||..||||||
|.^.E|||||
||||||||||
..........