||||||||||
|........|
|.|.||.|.|
|........|
|.|E|VE|.|
|.|P||||.|
|..E..E..|
|.|.||.|.|
|........|
||||||||||