||||||||||
|PE......|
|E.......|
|........|
|........|
|........|
|........|
|.......||
|^.....>D|
||||||||||