||||||||||
|P|D|..|E|
|.|E....E|
|.||||||.|
|........|
||||.....|
|||..|||||
|||E.|||||
||||.|||||
||||||||||