||||||||||
||D|.....|
||.|||||.|
|........|
|.||||||||
|........|
||||||||E|
|........|
|P.......|
||||||||||