||||||||||
||||||...|
||||||...|
||||D....|
|||||||E||
|...P||..|
|.||||||.|
|.|...||.|
|...|....|
||||||||||